type octile
height 15
width 15
map
TTeTTTTTTTTTTTT
T.............T
T.............T
T.............T
T.............T
T.............T
T.............T
T.............T
T.............T
T.............T
T.............T
T.............T
T.............T
T............sT
TTTTTTTTTTTTTTT