type octile
height 15
width 15
map
TTTTTTTTTTTTTTT
Te............T
T.............T
T.............T
T.............T
T.............T
T.............T
T.............T
T.............T
T.............T
T.............T
T.............T
T.............T
T............sT
TTTTTTTTTTTTTTT