type octile
height 18
width 21
map
TTTTTTTTTTTTTTTTTTTTT
Te..................T
T....TTTT...........T
T.......T...........T
T.......T....TTT....T
T............T......T
T...................T
T.....T.........T...T
T....TT.............T
T...................T
T.....T.......T.....T
T.....T.............T
T...........T.......T
T...TT......T.......T
T...T..........TT...T
T..........TT.......T
T..................sT
TTTTTTTTTTTTTTTTTTTTT