type octile
height 20
width 25
map
TTTTTTTTTTTTTTTTTTTTTTTTT
T.e.........T...........T
T..TTT......T..TT..TTT..T
T..T........T...........T
T..T........T...........T
T.......................T
T.......................T
T...........T...........T
T...........T...........T
T...TT..................T
T.......................T
T.......................T
T...........T...........T
T.......................T
T..TTT..................T
T.......................T
T.......................T
T..........TT...........T
T......................sT
TTTTTTTTTTTTTTTTTTTTTTTTT