type octile
height 30
width 15
map
TTsTTTTTTTTTTTT
T.............T
T.............T
T.............T
T.............T
T.............T
T.............T
T.............T
T.............T
T.............T
T.............T
T.............T
T.............T
T.............T
T.............T
T.............T
T.............T
T.............T
T.............T
T.............T
T.............T
T.............T
T.............T
T.............T
T.............T
T.............T
T.............T
T.............T
T............eT
TTTTTTTTTTTTTTT