type octile
height 20
width 31
map
TTeTTTTTTTTTTTTTTTTTTTTTTTTTTTT
T..T........T.................T
T..TTTT..T..T..TTTTTTTTTTTT...T
T..T........T.................T
T..T........T.................T
T..T........T.................T
T..T........T.................T
T..T........T.................T
T..T........T.................T
T..T..........................T
T.............................T
T.............................T
T...........T.................T
T.............................T
T...........T.................T
T.............................T
T...........T.................T
T...........T.................T
T............................sT
TTTTTTTTTTTTTTTTTTTTTTTTTTTTTTT